G PU  BS
SSXPG BG
PPPUSBGU
U XPSGSP
PB P S  
XUSUBUUX
BSBSGSGS
BPS XSXS
UUPXGGSU
