XXXXXXXX
X U   GX
XPXXXXXX
X XXXXXX
XXXXXXXX