XXXXXXXXXXXXXXXXXXXX XX
XUUUUUUUUUUUUUUUUUUUUUX
XGGGGGGG       UU     X
 UUUUUUUUUUUUUUUUUUUUU 
X                     X
X        SSS          X
X UUUUUUUUUUUUUUUUXXXXX
X  UUUUUUUUUUU    X P X
XXXXXXXXXXXXXXXXXXXX XX