XXXXXXX
X     X
X  P  X
X     X
X  G  X
XXXXXXX