XXXXXXX
X   T X
X P   X
X    GX
XXXXXXX