XXXXXXXXXX XXXXXXXXXX
XU   X     S      XTX
X XX X XXXXXXXXXX X X
X XPSSS          PX X
X X XX XXX XXX XX X X
       XGGGGGX       
X X XX XXX XXX XX X X
X XP             PX X
X X XXXXXXXXXX X XX X
XTX      S     X   UX
XXXXXXXXXX XXXXXXXXXX