XXXXXXXXXXXXXXXXX
XP     TXT     PX
X XX XXXXXXX XX X
X X     X     X X
X   XXX X XXX   X
XXX XUX X XUX XXX
X    UU X   UU  X
X XXXXXXXXXXXXX X
X     GGXGG     X
X XXX XXXXX XXX X
XU      UUU    UX
XXXXXXXXXXXXXXXXX