 P BSUPSU  P UG SSBU
GSSBUPSX PPSUSB  SSS
XX PUGSXBPBPSGG G  S
SPG PPPBBUXXGBP SXPB
 G   UPBXU GXUPXX SS
BGPGP   SU XPUPBSU B
SSXGSUPPG BG B UBXGU
 P  XXSSUS PPGU GXGU
BSB XUSSUXPG BSSP SG
GGUUSBGSPSSUUXUUGBUP
UG SBBSSGXS  BBXBUB 
