XXXXXXXXXXXGXXXXXXXXX
XU   X    X X     XTX
X XX X XXXXXXXXXX X X
X XP             PX X
XXX XX XXX XXX XX X X
 GX    XGG GGX       
XXX XX XXX XXX XX X X
X XP             PX X
X X XXXXXXXXXX X XX X
XTX      S     X   UX
XXXXXXXXXXX XXXXXXXXX