XXXXXXX
X U   X
XPX X X
X X  GX
XXXXXXX