XXXXXXXXXX XXXXXXXXXX
XU   X     S      XTX
X XX X XXXXXXXXXX X X
X XP             PX X
X X XX XXX XXX XX X X
       X G G X       
X X XX XXX XXX XX X X
X XP             PX X
X X XXXXXXXXXX X XX X
XTX      S     X   UX
XXXXXXXXXX XXXXXXXXXX